###############################################################################################################
#                                                                                                             #
#                                                                                                             #
#                                                                                                             #
#                                                                                                             #
#                                                                                                             #
#                                                                                                             #
#                ##########                             #                 #                                   #
#                    #                                   #               #                                    #
#                    #         ########                   #             #                                     #
#                    #              #                      #           #                                      #
#                                   #                       #         #                                       #
#                                   ####                     #       #                                        #
#                                      #                      #     #                                         #
#                                      #                       #   #                                          #
#                                      #                                                                      #
#                                      #                       #####                                          #
#                            #######          ############     #                                              #
#                                  #                           #                                              #
#                                  #                           #####                                          #
#                                  #                                                                          #
#                                  ######                      #   #                                          #
#                                                             #     #                                         #
#                                                            #       #                                        #
#                                                           #         #                                       #
#                                                          #           #                                      #
#                                                         #             #                                     #
#                                                        #               #                                    #
#                                                       #                 #                                   #
#                                                                                                             #
#                                                                                                             #
#                                                                                                             #
###############################################################################################################